P;V;E;D;GP;GC;SG
31;9;4;6;27;20;7
30;8;6;5;21;19;2
30;6;12;1;19;11;8
29;8;5;6;24;21;3
28;7;7;5;22;17;5
28;7;7;5;17;12;5
28;7;7;5;25;21;4
28;7;7;5;21;20;1
26;7;5;7;21;24;-3
25;7;4;8;22;29;-7
24;5;9;5;17;18;-1
23;7;2;10;25;28;-3
23;6;5;8;17;23;-6
23;5;8;6;20;18;2
23;5;8;6;23;23;0
22;4;10;5;20;20;0
21;5;6;8;19;21;-2
21;4;9;6;18;19;-1
19;4;7;8;15;20;-5
19;3;10;6;14;23;-9
