P;V;E;D;GP;GC;SG
66;18;12;8;50;34;16
65;19;8;11;51;35;16
61;17;10;11;34;24;10
60;17;9;12;41;35;6
58;16;10;12;44;30;14
58;14;16;8;39;28;11
57;16;9;13;45;36;9
55;15;10;13;44;41;3
54;15;9;14;33;35;-2
54;15;9;14;40;47;-7
51;14;9;15;36;40;-4
50;12;14;12;38;34;4
50;12;14;12;43;45;-2
48;13;9;16;44;50;-6
47;12;11;15;42;44;-2
47;12;11;15;43;52;-9
45;11;12;15;38;44;-6
41;10;11;17;34;47;-13
37;9;10;19;32;50;-18
29;6;11;21;25;45;-20
