P;V;E;D;GP;GC;SG
71;21;8;9;44;23;21
65;19;8;11;55;41;14
60;18;6;14;47;41;6
57;16;9;13;40;44;-4
56;16;8;14;47;47;0
56;13;17;8;38;30;8
55;15;10;13;37;39;-2
54;14;12;12;38;34;4
53;15;8;15;40;32;8
52;14;10;14;43;35;8
51;13;12;13;42;33;9
51;13;12;13;32;32;0
49;13;10;15;45;51;-6
49;13;10;15;39;45;-6
48;11;15;12;39;43;-4
44;12;8;18;37;44;-7
42;10;12;16;33;41;-8
42;10;12;16;40;49;-9
41;11;8;19;22;41;-19
41;10;11;17;30;43;-13
