P;V;E;D;GP;GC;SG
62;18;8;12;54;39;15
62;16;14;8;55;32;23
59;16;11;11;39;37;2
58;16;10;12;53;43;10
56;16;8;14;44;50;-6
56;15;11;12;40;39;1
54;14;12;12;40;36;4
52;13;13;12;37;30;7
51;14;9;15;48;45;3
51;13;12;13;39;40;-1
51;13;12;13;37;38;-1
51;12;15;11;34;34;0
50;13;11;14;43;46;-3
50;13;11;14;37;49;-12
48;12;12;14;45;42;3
47;12;11;15;46;48;-2
46;12;10;16;42;46;-4
45;12;9;17;40;47;-7
41;10;11;17;38;55;-17
39;9;12;17;38;53;-15
