P;V;E;D;GP;GC;SG
61;17;10;11;39;34;5
60;18;6;14;44;39;5
60;16;12;10;56;38;18
58;17;7;14;55;47;8
58;16;10;12;57;51;6
56;14;14;10;44;37;7
55;15;10;13;45;45;0
54;16;6;16;41;34;7
54;14;12;12;48;36;12
53;15;8;15;50;57;-7
53;14;11;13;43;40;3
52;15;7;16;37;40;-3
51;14;9;15;37;38;-1
51;12;15;11;41;40;1
50;13;11;14;39;42;-3
50;13;11;14;34;43;-9
43;10;13;15;39;46;-7
41;10;11;17;39;50;-11
39;8;15;15;44;54;-10
36;8;12;18;39;60;-21
