P;V;E;D;GP;GC;SG
80;25;5;8;56;28;28
62;18;8;12;44;39;5
62;17;11;10;42;32;10
62;16;14;8;50;35;15
61;17;10;11;39;27;12
59;17;8;13;46;44;2
56;15;11;12;41;38;3
53;14;11;13;40;38;2
51;15;6;17;44;47;-3
50;12;14;12;44;40;4
49;12;13;13;40;38;2
49;12;13;13;41;45;-4
48;14;6;18;39;43;-4
47;12;11;15;35;39;-4
45;12;9;17;47;49;-2
44;11;11;16;39;51;-12
42;10;12;16;33;46;-13
41;9;14;15;35;50;-15
38;10;8;20;34;49;-15
38;9;11;18;44;55;-11
